31 31 31 31 31 31 31 31 31 31 31 31 38 29 29 10 10 10 00 00 00 00 00 00 00 46 00 00 00 00 00 00 00 00 00 00 00 00 00 00 00 00 00 00 00 00 00 00 00 00 00 00 00 00
10 10 10 10 10 10 10 10 10 10 10 10 37 29 29 30 30 30 00 00 00 00 00 00 00 00 00 00 00 00 00 00 00 46 00 00 00 00 00 17 00 00 00 00 00 00 00 00 00 00 00 00 00 00
10 10 10 10 10 10 10 10 10 10 10 10 37 29 29 29 29 29 46 00 00 00 00 00 46 00 00 00 46 00 00 17 00 00 00 00 00 00 46 00 00 00 00 46 00 00 00 00 00 00 00 00 00 00
10 10 10 10 10 10 10 10 32 23 23 23 39 29 29 29 29 29 00 00 00 46 00 00 00 00 00 00 00 00 46 00 00 00 00 46 00 00 00 00 00 00 00 17 00 00 00 00 00 00 00 00 00 00
10 10 10 10 10 10 10 10 35 27 27 27 31 31 31 31 38 29 00 00 00 00 00 12 03 16 03 03 03 03 16 03 03 03 03 03 16 03 03 03 11 00 00 00 00 00 46 00 00 00 00 00 00 00
10 10 10 10 10 10 10 10 33 10 10 10 10 10 10 10 37 29 00 46 00 00 00 05 10 10 10 10 10 10 10 10 10 10 10 10 10 10 10 10 04 00 00 46 00 00 00 00 00 00 00 00 00 00
10 10 10 10 10 10 10 10 33 10 10 10 10 10 10 10 37 29 00 00 00 46 00 05 10 10 10 10 10 10 10 10 10 10 10 10 10 10 10 10 04 46 00 46 00 46 00 46 00 00 00 00 00 00
10 10 10 10 10 10 10 10 33 45 26 26 26 25 24 10 04 00 46 00 00 00 00 05 10 10 10 10 10 10 10 10 10 10 10 10 10 10 10 10 04 00 00 00 46 00 00 00 00 17 00 00 00 00
10 10 10 10 10 10 10 10 33 10 10 10 01 04 05 10 04 00 46 00 00 00 00 05 10 10 10 10 10 10 10 10 10 10 10 10 10 10 10 10 04 00 00 00 00 00 00 00 00 00 00 00 00 00
10 10 10 10 10 10 10 10 33 10 10 10 10 04 05 10 04 00 00 00 00 46 00 05 26 26 26 26 45 26 26 26 26 26 26 26 26 26 26 26 04 46 00 46 00 00 00 00 00 00 00 00 00 00
10 10 10 10 10 10 10 10 33 10 10 10 10 04 05 10 04 00 00 00 00 00 46 05 10 10 10 10 10 10 10 10 10 10 10 10 10 10 10 10 04 00 00 46 00 46 00 00 46 00 00 00 00 00
10 10 10 10 10 10 10 10 43 02 15 02 02 06 05 10 04 00 00 00 46 00 00 05 10 10 10 10 10 10 10 10 10 10 10 10 10 10 10 10 04 46 00 12 03 11 46 00 00 00 00 00 00 00
23 23 23 23 23 23 23 23 44 00 46 00 00 00 05 10 04 00 46 00 00 00 00 05 10 10 10 10 10 10 10 10 10 10 10 10 10 10 10 10 04 00 46 05 10 04 00 00 00 00 00 00 00 00
28 28 28 28 28 28 28 28 42 00 00 00 00 46 05 10 04 00 00 00 00 00 00 05 10 10 10 10 10 10 10 10 10 10 10 10 10 10 10 10 04 00 00 05 10 04 00 46 00 00 00 00 00 00
40 40 40 40 40 40 40 40 41 00 00 46 00 00 05 10 04 00 00 00 00 00 46 07 02 20 02 02 02 02 02 02 02 02 02 02 02 02 22 10 04 00 00 05 10 04 46 00 00 17 00 00 00 00
00 00 46 00 00 00 00 00 46 00 00 00 46 00 05 10 04 00 00 00 00 00 00 00 46 20 00 17 00 00 00 12 03 11 00 46 00 00 05 10 04 46 00 05 10 04 00 00 00 46 00 00 00 00
00 00 00 00 00 46 00 00 00 17 00 00 00 00 05 10 04 00 00 46 00 00 00 00 00 20 00 00 00 46 00 05 10 04 00 00 00 00 05 10 04 00 00 05 10 04 00 46 00 00 00 00 00 00
00 00 00 00 00 00 00 00 12 16 03 03 11 00 05 10 04 46 00 00 00 17 00 00 00 20 46 00 00 00 00 05 10 04 00 17 46 00 05 10 04 17 00 05 10 04 00 00 00 00 46 00 00 00
00 00 00 00 00 46 00 00 05 10 10 10 04 46 05 10 08 16 03 03 03 16 03 03 03 20 03 16 03 03 16 09 10 04 00 00 00 00 05 10 04 00 00 05 10 04 00 00 46 00 00 00 00 00
00 00 46 00 00 00 00 00 05 10 10 10 08 03 09 10 10 10 10 10 10 10 10 10 10 10 10 10 10 10 10 10 10 04 00 00 00 00 05 10 04 00 46 05 10 04 46 00 46 00 00 00 00 00
00 00 00 00 00 00 00 46 05 10 10 10 10 10 10 10 10 10 10 10 10 10 10 10 10 10 10 10 10 10 10 10 10 04 00 00 00 00 05 10 08 03 03 09 10 04 17 00 00 00 00 00 00 00
00 00 00 46 00 00 46 00 05 10 10 10 21 15 22 10 10 10 10 10 10 10 10 10 10 10 10 10 10 10 10 10 10 04 46 00 00 46 05 10 10 10 10 10 10 04 00 46 00 00 00 00 00 00
00 00 00 00 00 00 00 00 05 10 10 10 04 46 05 10 10 10 10 10 10 10 10 10 10 10 10 10 10 10 10 10 10 04 17 00 00 00 07 02 15 02 15 02 02 06 00 00 00 00 00 00 00 00
00 00 00 00 00 46 00 00 07 02 15 02 06 00 07 02 02 02 02 02 15 02 02 02 02 02 15 02 02 15 02 02 15 06 00 00 00 46 00 00 00 00 00 00 00 00 00 00 00 00 00 00 00 00
00 00 00 00 00 00 00 17 00 00 00 46 00 00 00 00 00 00 00 00 00 00 00 46 00 00 00 00 00 00 46 00 00 00 00 46 00 00 00 00 00 00 17 46 00 00 00 00 00 46 00 00 00 00
00 00 00 00 00 00 00 46 00 00 00 00 00 46 00 00 00 00 00 00 00 00 00 00 00 00 00 46 00 00 00 00 00 00 00 00 00 00 00 00 46 00 00 00 00 00 00 00 00 00 00 00 00 00
00 00 00 00 00 46 00 00 00 00 46 00 00 00 00 00 00 00 46 00 00 00 00 00 00 00 00 00 00 00 00 00 00 00 00 00 00 00 00 00 00 00 00 00 00 00 00 00 00 00 00 00 00 00
00 00 00 00 00 00 00 00 00 00 00 00 00 00 00 00 00 00 00 00 00 00 00 00 00 00 00 00 00 00 00 00 00 00 00 00 00 00 00 00 00 00 00 00 00 00 00 00 00 00 00 00 00 00
00 00 00 00 00 00 00 00 00 00 00 00 00 00 00 00 00 00 00 00 00 00 00 00 00 00 00 00 00 00 00 00 00 00 00 00 00 00 00 00 00 00 00 00 00 00 00 00 00 00 00 00 00 00
00 00 00 00 00 00 00 00 00 00 00 00 00 00 00 00 00 00 00 00 00 00 00 00 00 00 00 00 00 00 00 00 00 00 00 00 00 00 00 00 00 00 00 00 00 00 00 00 00 00 00 00 00 00
01 02 03 04 05 06 07 08 09 10 11 12 13 14 15 16 17 10 02 20 21 22 23 24 25 26 27 28 29 30 31 32 33 34 35 36 37 38 39 40 41 42 43 44 45 46 47 48 49 50 51 52 53 54